25
20
--------------------
-000000000000000000-
-0-0-0-0-00-0-0-0-0-
-000000000000000000-
-0-0-0-0-00-0-0-0-0-
-000000000000000000-
-0-0-0-0-00-0-0-0-0-
-000000000000000000-
-0-0-0-- -- --0-0-0-
-00000        00000-
-0-0-0- --R- -0-0-0-
-00000- ---- -00000-
-0-0-0  G--Y  0-0-0-   
-00000- ---- -00000-
-0-0-0- -B-- -0-0-0-
-00000        00000-
-0-0-0-- -- --0-0-0-
-000000000000000000-
-0-0-0-0-00-0-0-0-0-
-000000000000000000-
-0-0-0-0-0P0-0-0-0-0-
-000000000000000000-
-0-0-0-0-00-0-0-0-0-
-000000000000000000-
--------------------