25
20
--------------------
-R0000000--0000000B-
-0-0--0-0--0-0--0-0-
-000--000--000--000-
-0-0--0-0--0-0--0-0-
-00000000--00000000-
-0------0--0------0-
-00000000--00000000-
-0-0--0-0--0-0--0-0-
-000--000--000--000-
-0-0--0-0--0-0--0-0-
-000000000000000000-
--------0P00--------
-000000000000000000-
-0-0--0-0--0-0--0-0-
-000--000--000--000-
-0-0--0-0--0-0--0-0-
-00000000--00000000-
-0------0--0------0-
-00000000--00000000-
-0-0--0-0--0-0--0-0-
-000--000--000--000-
-0-0--0-0--0-0--0-0-
-G0000000000000000Y-
--------------------